_, 3, _, _, 2, 1, _, 2, _, 2, 1
_, 4, 4, _, 3, 2, _, 2, 1, 2, _
3, _, 2, 2, _, 2, 1, 1, 0, 1, 1
_, 2, 2, 2, _, _, 0, 0, 0, 0, 0
1, 2, 2, _, 2, 1, 0, 0, 0, 0, 0
0, 1, _, 3, _, 2, _, 1, 0, _, _
0, 1, 1, 3, 2, 4, _, 2, 0, 1, _
1, 2, 1, 3, _, 4, _, 4, 2, 3, 2
_, 2, _, 4, _, 4, 3, _, _, 3, _
2, 3, 1, _, _, 2, _, _, _, 3, 1
_, 1, 0, 1, 1, 1, 2, _, _, _, 0