_, 2, _, 2, 1, 1, _, 2, _, 2, 1
3, 3, 3, _, 2, 2, _, 2, 1, 2, _
2, _, 2, 2, _, 2, 1, 1, 0, 1, 1
_, 2, 2, 2, 2, _, 0, 0, 0, 0, 0
1, 2, 2, _, 2, 1, 0, 0, 0, 0, 0
0, 1, _, 3, _, 1, _, 0, 0, _, _
0, 1, 1, 2, 1, 2, 1, 1, 0, 1, _
1, 2, 1, 2, 1, 2, _, 3, 2, 3, 2
_, 2, _, 3, _, 3, 2, _, _, 3, _
1, 2, 1, 3, _, 2, _, 4, _, 3, 1
0, 0, 0, 1, 1, 1, 1, _, 2, 1, 0