T, 2, T, 2, 1, 1, G, 2, T, 2, 1
3, 3, 3, T, 2, 2, T, 2, 1, 2, T
2, T, 2, 2, T, 2, 1, 1, 0, 1, 1
T, 2, 2, 2, 2, G, 0, 0, 0, 0, 0
1, 2, 2, T, 2, 1, 0, 0, 0, 0, 0
0, 1, T, 3, T, 1, G, 0, 0, G, G
0, 1, 1, 2, 1, 2, 1, 1, 0, 1, T
1, 2, 1, 2, 1, 2, T, 3, 2, 3, 2
T, 2, T, 3, T, 3, 2, T, T, 3, T
1, 2, 1, 3, T, 2, G, 4, T, 3, 1
0, 0, 0, 1, 1, 1, 1, T, 2, 1, 0