T, 3, T, T, 2, 1, G, 2, T, 2, 1
T, 4, 4, T, 3, 2, T, 2, 1, 2, T
3, T, 2, 2, T, 2, 1, 1, 0, 1, 1
T, 2, 2, 2, G, G, 0, 0, 0, 0, 0
1, 2, 2, T, 2, 1, 0, 0, 0, 0, 0
0, 1, T, 3, T, 2, G, 1, 0, G, G
0, 1, 1, 3, 2, 4, T, 2, 0, 1, T
1, 2, 1, 3, T, 4, T, 4, 2, 3, 2
T, 2, T, 4, T, 4, 3, T, T, 3, T
2, 3, 1, G, T, 2, G, T, T, 3, 1
T, 1, 0, 1, 1, 1, 2, T, G, G, 0