_, 2, 2, _, 1
_, _, _, 2, 1
_, 5, _, _, 1
_, _, 3, 3, _
_, 3, _, _, _