2, T, 2, 0, G, G, 1, 2, 1, 2, T, 2, 2, G, 1
2, T, 3, 1, 1, 2, T, 3, T, 2, 2, 4, T, T, 2
2, 2, 2, T, 1, 2, T, 4, 2, 1, 2, T, T, 4, T
T, 1, 1, 1, 1, G, 3, T, 2, 1, 2, T, 4, 4, 2
1, 1, 0, G, 1, 3, T, 4, T, 1, 1, 2, T, 2, T
1, 1, 0, 1, T, 4, T, 4, 1, 2, 1, 2, G, 2, 1
T, 2, 1, 2, 1, G, T, 2, 0, 1, T, 1, 1, 1, 1
1, 3, T, G, 1, 2, 2, 1, 0, 1, 1, 1, 1, T, 1
0, G, T, 2, 1, T, 1, 0, 1, G, 2, 1, 2, 1, 1
G, 2, 2, 1, 1, 1, 1, 0, 1, T, 2, T, 2, G, 1
1, T, 1, G, G, G, 1, 1, 1, G, 3, G, T, 3, T
3, G, 2, 0, 0, 1, T, 1, 0, 0, 1, T, T, 4, G
T, T, 1, 0, 1, 2, 2, 2, 1, 1, 1, 2, 4, T, 2
2, 2, 1, 1, 2, T, G, 1, T, 2, 2, 2, 3, T, 2
0, G, 0, 1, T, 2, G, 1, 1, 2, T, T, 2, 1, 1