G, 0, G, T, T, T, 1, 0, 1, 1, 2, T, T, 1, 0, 0, G, 1, T, 1
G, 1, 2, G, 4, 3, 2, 1, 2, T, 3, 2, 2, 1, 0, 0, 0, 2, 2, 2
T, G, 1, T, 2, G, T, 1, 3, T, 3, G, 0, 0, 0, 0, 0, 1, T, 1
2, 3, 3, 2, 2, T, 3, G, 2, T, 2, 0, 1, 1, 2, 1, 1, 2, 2, 2
1, T, T, 2, G, G, T, 2, 1, 1, 1, 0, 1, T, 2, T, 1, 1, T, 1
1, 4, T, G, 0, G, T, 3, 0, 0, 0, 0, G, 2, 3, 1, 1, 1, 1, 1
0, 2, T, 2, 0, 2, T, 2, 0, 0, G, 0, 1, T, G, G, 0, 0, G, 0
1, 2, 2, 1, 0, 2, G, 2, 1, G, 2, 1, 3, 4, T, 3, 1, 0, 0, 0
1, T, 2, 1, 0, 1, T, 1, 2, T, 3, T, 2, T, T, T, 3, G, 3, 2
1, 2, T, 1, 0, 1, 1, 1, 2, T, 3, 1, 2, G, T, G, T, T, T, T
0, 2, 3, G, 1, 0, 0, 0, 1, 2, 3, 2, 1, 2, 2, 4, 3, 5, G, G
1, 3, T, T, G, 2, 2, 1, 1, 3, T, T, 1, G, T, 2, T, 3, T, 2
2, T, T, 4, G, T, T, 3, 3, T, T, 4, 2, 2, 1, 2, 2, 4, T, 2
T, 6, T, 3, G, 4, 4, T, T, G, 3, 2, T, 1, G, 1, 2, T, 2, 1
T, T, 3, 2, T, 2, T, 4, T, T, 2, 2, 3, 2, 2, T, 4, 3, 3, 1
G, T, 2, 2, 2, 4, 2, 3, 2, 2, 2, T, G, T, 2, 2, T, T, 3, T
1, 2, 2, 3, T, G, T, 2, 1, 1, 1, 2, T, 3, 2, G, G, T, 3, 1
1, 2, T, 5, T, 4, 1, 2, T, 1, 0, G, 2, T, 2, 1, 2, 1, 1, 0
T, 4, 4, T, T, G, 0, 1, 1, 1, 0, 0, 1, 1, 2, T, 1, 0, 0, 0
T, T, 3, T, 3, 1, 0, 0, 0, 0, 0, 0, G, 0, 1, 1, 1, 0, 0, 0