T, 1, 1, T, 3, 2, 3, T, T
3, 3, 3, 3, T, T, 6, T, 5
T, T, 2, T, 5, T, T, T, T
4, 4, 3, 2, 4, T, 5, 4, 2
T, T, 2, 3, T, 4, T, 3, 2
T, 5, T, 3, T, 4, 3, T, T
T, 4, 2, 2, 1, 2, T, 4, 3
3, T, 2, G, G, 2, 2, 3, T
2, T, 2, G, G, 1, T, 2, 1
